---
title: "Codebuch.txt"
author: "Bianca List"
date: "22 2 2021"
output: html_document
---

```{r setup, include=FALSE}
knitr::opts_chunk$set(echo = TRUE)
```
Codebuch

type
person = 0
organisation = 1

rank
vorstand = v
aufsichtsrat = ar

representation
politik = p
wirtschaft = w
gewerkschaft = g
umwelt = u
sport = s
wissenschaft = wi
verwaltung = ver
kommunikation = k
einkauf = e

position
vorsitz = vo
stellvertreter = st
mitglied in der vfb organisation = m

